


1111111111111
100100C0000C1
1C00011111001
100011E000001
100100C0000C1
100100C0000C1
100100C00P0C1
100100C0000C1
100100111C101
1001001001111
100100C000101
1111111111111
